5,5
11111
12221
12101
12001
11111
