21,21
111111111111111111111
122222222222222222221
121121112111121112121
122222222222223222221
121121211111121211221
122222222222122222211
111121112121112121111
111121222222222121111
111121221111112121111
122222222222222222221
111121211111212111111
122222222221222222221
121121112221211122211
122121222122211121111
112121211111211122221
122232222211222221121
122221111222221111221
121121112211122122211
122221222211121111221
122222222222222222221
111111111111111111111
>>>>>>> 52cd6c57c061e0f4f6ad61fc1479156de40385a0
