9,9
111111111
122220031
121120101
121220001
000210020
101220021
101121121
100022221
111111111
