15,15
111111101111111
100000000000001
101110010011101
101222212222101
101112111211101
100003111300001
122222111222221
000111131111000
100122222221001
100111000111001
122202222202221
101222111222101
101112232211101
100000000000001
111111101111111
